###############
#         #   #
####  ### #   #
#   # #     # #
# # # #  #### #
# #   #       #
#   #    ## # #
#     ##    # #
# # ####    # #
#       # #   #
#    ## # # # #
### #   # # # #
#E# # # #   # #
#   #         #
###############