###############
#             #
# #   ## ## # #
##    #     # #
# # # # # # # #
#         #   #
# #  # ## #   #
#         # # #
# # ## # ## ###
# #           #
# ####### # # #
## E#   #     #
# # #   ## ## #
#     #       #
###############