###############
# #     #     #
#  # ## #    ##
#    #        #
##  # # # # # #
#     #   # # #
# #  ##     # #
# #   #     # #
#  ## ## ## # #
#   #     #   #
# ## #### #   #
# #    E#     #
# #   ### # # #
#   ##        #
###############