###############
#        #    #
##### # #   # #
#       # #   #
# ## ###  # # #
#   #   #     #
#   # # ### # #
#   #         #
###   ### ### #
#   #         #
# ### # # # ###
#       # #   #
####     ##   #
#E   # #      #
###############