###############
#             #
# #   ##   ## #
# # #   #   # #
# ##### # # # #
#       #     #
# #   ##    # #
#   #     # # #
# ######  #   #
#     #       #
# # ### # #  ##
#     # #     #
#  ##   # ### #
#         #E  #
###############