###############
# #         # #
#    ## ### # #
##            #
# # ##### #   #
#             #
#  #  # ##  ###
#     #     # #
# ####   ## # #
#     # #     #
# ### # ###   #
# # #   #E    #
# # #   # ### #
#   #         #
###############