###############
#   #    #  # #
# # # ## ## # #
# #         # #
# #     # #   #
#     #       #
##   ### ### ##
# #   #       #
#  #  #   ### #
#     #       #
# # ##  #### ##
#        ##   #
#       #   # #
#       #   # #
### ##  #E# # #
#       #   # #
###############