#################
#   #    #  # ###
# # # ## ## # ###
# #         # ###
# #     # #   ###
#     #       ###
##   ### ### ####
# #   #       ###
#  #  #   ### ###
#     #       ###
# # ##  #### ####
#        ##   ###
### ##  #E# # ###
#       #   # ###
#################