###############
# #           #
# # #####     #
#       #     #
# ##  #    #E##
#     # #     #
####### #  #  #
#         #   #
# ###  ## # # #
#           # #
##  ###     # #
#   #       # #
# # ####### # #
#             #
###############