###############
#             #
# #####  ## ###
#     #       #
#   # # # # # #
## #  # # #   #
# ## ##       #
# #       #   #
#   ### ### # #
#         #E  #
##  # ##  ### #
#     #       #
# ##  # #######
#             #
###############