###############
#E#           #
# #######  #  #
# #     # #   #
# # #   #   # #
# #     #   # #
# # # # #  #  #
# #       #   #
#   #  ## # ###
#   # #     # #
### #    # #  #
# # # # # #   #
#   # #     # #
#     # #     #
###############